1111111111111111111111111111111111
100E000000000000000000000000000001
1010010100100000101001000000010101
1010010010101010001001000000010101
1C1000000C0000000000000000000P0001
1111111111111111111111111111111111